111111111111111
1P0020020200201
101010101210121
120002020020021
101210101010121
10020200220N001
101010101010101
1020220N00220N1
10101010101N101
1202200N0200021
101012101210101
12202000N000N01
111111111111111
