111111111111111
1P020N202222021
1012121N1N10101
120202202220221
1012101N1212101
10200202200N021
121N12121212121
1202020N0020221
121012101210121
1n0220202022201
121210121212101
12202202N002021
111111111111111
