111111111111111
1P022N000220001
101N10101010101
120002002002001
101210121012101
1002020202000N1
121010101012101
1020N002N002021
101010101010101
120200220022001
101010101010101
1200N000200N001
111111111111111
