111111111111111
1P0220202022201
101N10121010121
12000200N020021
12121010101N101
120202200200201
101210101N12101
120N00222002221
121210121010101
10N200020N02021
121012101012121
1220N0022202001
111111111111111
