111111111111111
1P0002000000201
1012121010101N1
1200N2000200001
101012101010101
122N22000N000N1
101010101010101
1002N0000000001
101010101N10101
100020N00000N01
101010101010101
100000000020001
111111111111111
